HWWWWWWWWWWWWWWWWWWWWWWWWWWWW
 WWWWWWWWWWWWWWWWWWWWWTWWWWWW
 WWWWWWWWWWWWWWWWWWWWW WWWWWW
 WWWWWWWWWWWWWWWWWWWWW WWWWWW
T              |      MWWWWWW
WWWWWWWWWWWWW  O--WWWWWWWWWWW
WWWWWWWWWWWWW     WWWWWTWWWWW
WWWWWWWWWWWWW WWWWWWWWW WWWWW
WWWWWWWWWWWWW WWWWWWWWW WWWWW
WWWWWWWWWWWWW   WWWWWWW WWWWW
                M       WWWWW
 WWWWWWWWWW--O--WWWW   TWWWWW
 WWWWWWWWWW     WWWW WWWWWWWW
    MWWWWWWWW WWWWWW WWWWWWWW
     WWWWWWWW WWWWWW WWWWWWWW
T    WWWWWWWW               E
