H WWWWWWWWWWWWWWWWWWWWWWWWWWW
  WWWWWWWWWWWWWWWWWWWW TWWWWW
  WWWWWWWWWWWWWWWWWWWW  WWWWW
  WWWWWWWWWWWWWWWWWWWW  WWWWW
               |       MWWWWW
WWWWWW         O--WWWWWWWWWWW
WWWWWWWWWWWWW     WWWWT WWWWW
WWWWWWWWWWWWW  WWWWWWW  WWWWW
WWWWWWWWWWWWW  WWWWWWW  WWWWW
WWWWWWWWWWWWW   WWWWWW  WWWWW
                M       WWWWW
 WWWWWWWWWW--O--WWWW    WWWWW
 WWWWWWWWWW     WWWW  WWWWWWW
    MWWWWWWWW  WWWWW  WWWWWWW
     WWWWWWWW  WWWWW  WWWWWWW
T    WWWWWWWW               E
